Step    1:    1 -->    6
Step    2:    1 -->    7
Step    3:    3 -->    6
Step    4:    2 -->    3
Step    5:    4 -->    1
Step    6:    4 -->    6
Step    7:    2 -->    4
Step    8:    2 -->    1
Step    9:    3 -->    2
Step   10:    3 -->    1
Step   11:    2 -->    3
Step   12:    5 -->    7
Step   13:    5 -->    4
Step   14:    5 -->    7
Step   15:    5 -->    6
