Step    1:    1 -->    6
Step    2:    2 -->    7
Step    3:    3 -->    7
Step    4:    5 -->    6
Step    5:    5 -->    3
Step    6:    5 -->    1
Step    7:    3 -->    5
Step    8:    1 -->    3
Step    9:    4 -->    5
Step   10:    4 -->    7
Step   11:    4 -->    2
Step   12:    3 -->    4
Step   13:    2 -->    3
