Step    1:    1 -->    4
Step    2:    1 -->    5
Step    3:    2 -->    4
Step    4:    2 -->    5
Step    5:    1 -->    2
Step    6:    1 -->    4
Step    7:    3 -->    5
Step    8:    3 -->    2
Step    9:    3 -->    4
Step   10:    3 -->    5
