Step    1:    2 -->    8
Step    2:    3 -->    8
Step    3:    4 -->    8
Step    4:    2 -->    4
Step    5:    2 -->    9
Step    6:    5 -->    8
Step    7:    5 -->    9
Step    8:    6 -->    9
Step    9:    7 -->    5
Step   10:    3 -->    7
Step   11:    3 -->    5
Step   12:    1 -->    3
Step   13:    1 -->    2
Step   14:    1 -->    9
Step   15:    6 -->    1
Step   16:    5 -->    6
Step   17:    2 -->    5
Step   18:    7 -->    3
Step   19:    4 -->    7
Step   20:    4 -->    1
Step   21:    4 -->    5
